11111111111111111111111111111111
11111111111110000000000001111111
11111111111110000PCC000001111111
111111111111111110CC011111111111
111111111111111110C0011111111111
111111111111111110C0011111111111
11111111111111111000011111111111
11111111111111111000011111111111
11111111111111111000011111111111
11111111111000000001E11111111111
11111111111000000001C11111111111
11111111111111111111111111111111
