1111111111
1000000001
1CCCCCCP01
1E00000001
1111111111