1111111111111111111
10000000P0000000001
1000000000000000001
100E0C0000000000011
1111111111111111111
111111111111111C111
1111111111111111111